WL WL WL WL WL WL WL WL WL WL WL WL WL WL WL WL
WL FR FR FR FR FR FR FR FR FR FR FR FR FR FR WL
WL FR WL WL WL FR WL FR WL WL FR WL WL WL FR WL
FR FR FR FR FR FR FR FR FR FR FR FR WL FR FR FR
FR FR WL FR WL WL WL FR FR WL FR FR WL WL FR FR
WL FR WL FR WL FR FR FR WL WL WL FR FR FR FR WL
WL FR WL FR FR FR FR FR FR FR FR FR FR FR FR WL
WL FR FR FR WL WL WL FR FR FR WL WL WL WL FR WL
WL FR WL FR FR FR FR FR WL FR FR FR FR FR FR WL
WL FR FR FR WL WL WL FR WL FR FR FR FR FR FR WL
WL FR WL FR FR FR FR FR WL WL WL WL FR WL FR WL
FR FR FR FR WL FR FR FR FR FR FR FR FR FR FR FR
FR FR WL FR WL WL WL FR FR WL WL WL FR FR FR FR
WL FR FR FR FR FR WL FR FR WL FR FR FR WL FR WL
WL FR FR FR FR FR FR FR FR FR FR FR FR FR FR WL
WL WL WL WL WL WL WL WL WL WL WL WL WL WL WL WL